EEEEEEEEEEEEEEEEEEEEEEEEEEEEEEEEEEEEEEEEEEEEEEEEEEEEEEEEEEEEEEEE
EEEEEEEEEEEEEEEEEEEEEEEEEEEEEEEEEEEEEEEEEEEEEEEEEEEEEEEEEEEEEEEE
EEEEEEEEEEEEEEEEEEEEEEEEEEEEEEEEEEEEEEEEEEEEEEEEEEEEEEEEEEEEEEEE
EEEEEEEEEEEEEEEEEEEEEEEEEEEEEEEEEEEEEEEEEEEEEEEEEEEEEEEEEEEEEEEE
EEEEEEEEEEEEEEEEEEEEEEEEEEEEEEEEEEEEEEEEEEEEEEEEEEEEEEEEEEEEEEEE
WWWWWWWWWWWWWWWWWWWWWWWWWWWWWWWWWWWWWWWWWWWWWWWWWWWWWWWWWWWWWWWW
WWWWWWWWWWWWWWWWWWWWWWWWWWWWWWWWWWWWWWWWWWWWWWWWWWWWWWWWWWWWWWWW
NNEEEEEEEEEEEEEEEEEEEEEEEEEEEEEEEEEEEEEEEEEEEEEEEEEEEEEEEEEEEENN
NNEEEEEEEEEEEEEEEEEEEEEEEEEEEEEEEEEEEEEEEEEEEEEEEEEEEEEEEEEEEENN
NNEEEEEEEEEEEEEEEEEEEEEEEEEEEEEEEEEEEEEEEEEEEEEEEEEEEEEEEEEEEENN
NNEEEEEEEEEEEEEEEEEEEEEEEEEEEEEEEEEEEEEEEEEEEEEEEEEEEEEEEEEEEENN
NNEEEEEEEEEEEEEEEEEEEEEEEEEEEEEEEEEEEEEEEEEEEEEEEEEEEEEEEEEEEENN
NNEEEEEEEEEEEEEEEEEEEEEEEEEEEEEEEEEEEEEEEEEEEEEEEEEEEEEEEEEEEENN
NNEEEEEEEEEEEEEEEEEEEEEEEEEEEEEEEEEEEEEEEEEEEEEEEEEEEEEEEEEEEENN
NNEEEEEEEEEEEEEEEEEEEEEEEEEEEEEEEEEEEEEEEEEEEEEEEEEEEEEEEEEEEENN
NNEEEEEEEEEEEEEEEEEEEEEEEEEEEEEEEEEEEEEEEEEEEEEEEEEEEEEEEEEEEENN
NNEEEEEEEEEEEEEEEEEEEEBEEEEEEEEEEEEEEBEEEEEEEEEEEEEEEEEEEEEEEENN
NNEEEEEEEEEEEEEEEEEEEEEEEEEEEEEEEEEEEEEEEEEEEEEEEEEEEEEEEEEEEENN
NNEEEEEEEEEEEEEEEEEEEEEEEEEEEEEEEEEEEEEEEEEEEEEEEEEEEEEEEEEEEENN
NNEEEEEEEEEWWWWWWWWWWWWWWWWWWWWWWWWWWWWWWWWWWWWWWWWWEEEEEEEEEENN
NNEEEEEEEEEWWWWWWWWWWWWWWWWWWWWWWWWWWWWWWWWWWWWWWWWWEEEEEEEEEENN
NNEEEEEEEEEEEEEEEEEEEEEEEEEEEWWWWWEEEEEEEEEEEEEEEEEEEEEEEEEEEENN
NNEEEEEEEEEEEEEEEEEEEEEEEEEEEWWWWWEEEEEEEEEEEEEEEEEEEEEEEEEEEENN
NNEEEEEEEEEEEEEEEEEEEEEEEEEEEWWWWWEEEEEEEEEEEEEEEEEEEEEEEEEEEENN
WWEEEEEEEEEEEEEEEEEEEEEEEEEEEWWWWWEEEEEEEEEEEEEEEEEEEEEEEEEEEENN
WWEEEEEEEEEEEEEEEEEEEEEEEEEEEWWWWWEEEEEEEEEEEEEEEEEEEEEEEEEEEE0F
WWEEEBEEEEEEEEEEEEEEEEEEEEEEEWWWWWEEEEEEEEEEEEEEEEEEEEEEBEEEEEWF
WWEEEEEEEEEEEEEEEEEEEEEEEEEEEWWWWWEEEEEEEEEEEEEEEEEEEEEEEEEEEEWF
WWEEEEEEEEEEEEEEEEEEEEEEEEEEEWWWWWEEEEEEEEEEEEEEEEEEEEEEEEEEEEWF
WWWWWWWWWWWWWWWWWWEEEEEEEEEEEWWWWWEEEEEEEEEEEWWW4WWWWWWWWWWWWWWW
WWWWWWWWWWWWWWWWWWEEEEEEEEEEEWWWWWEEEEEEEEEEEWWWWWWWWWWWWWWWWWWW
NNEEEEEEEEEEEEEEEEEEEEEEEEEEEWWWWWEEEEEEEEEEEEEEEEEEEEEEEEEEEEWW
NNEEEEEEEEEEEEEEEEEEEEEEEEEEEWWWWWEEEEEEEEEEEEEEEEEEEEEEEEEEEEWW
NNEEEEEEEEEEEEEEEEEEEEEEEEEEEWWWWWEEEEEEEEEEEEEEEEEEEEEEEEEEEEWW
NNEEEEEEEEEEEEEEEEEEEEEEEEEEEWWWWWEEEEEEEEEEEEEEEEEEEEEEEEEEEEWW
NNEEEEEEEEEEEEEEEEEEEEEEEEEEEWWWWWEEEEEEEEEEEEEEEEEEEEEEEEEEEEWW
NNEEEEEEEEEEEEEEEEEEEEEEEEEEEWWWWWEEEEEEEEEEEEEEEEEEEEEEEEEEEEWW
NNEEEEEEEEEEEEEEEEEEEEEEEEEEEWWWWWEEEEEEEEEEEEEEEEEEEEEEEEEEEEWW
NNEEEEEEEEEEEEEEEEEEEEEEEEEEEWWWWWEEEEEEEEEEEEEEEEEEEEEEEEEEEEWW
NNEEEEEEEEEEEEEEEEEEEEEEEEEEEWWWWWEEEEEEEEEEEEEEEEEEEEEEEEEEEEWW
NNEEEEEEEEEEEEEEEEEEEEEEEEEEEEEEEEEEEEEEEEEEEEEEEEEEEEEEEEEEEEWW
NNEEEEEEEEEEEEEEEEEEEEEEEEEEEEEEEEEEEEEEEEEEEEEEEEEEEEEEEEEEEEWW
NNEEEEEEEEEEEEEEEEEEEEEEEEEEEEEEEEEEEEEEEEEEEEEEEEEEEEEEEEEEEEWW
NNEEEEEEEEEEEEEEEEEEEEEEEEEEEEEEEEEEEEEEEEEEEEEEEEEEEEEEEEEEEEWW
NNEEEEEEEEEEEEEEEEEEEEEEEEEEEEEEEEEEEEEEEEEEEEEEEEEEEEEEEEEEEEWW
NNEEEEEEEEEEEEEEEEEEEEEEEEEEEEEEEEEEEEEEEEEEEEEEEEEEEEEEEEEEEEWW
NNEEEEEEEEEEEEEEEEEEEEEEEEEEEEEEEEEEEEEEEEEEEEEEEEEEEEEEEEEEEEWW
NNEEEEEEEEEEEEEEEEEEEEEEEEEEEEEEEEEEEEEEEEEEEEEEEEEEEEEEEEEEEEWW
NNEEEEEEEEEEEEEEEEEEEEEEEEEEEEEEEEEEEEEEEEEEEEEEEEEEEEEEEEEEEEWW
NNEEEEEEEEEEEEEEEEEEEEEEEEEEEEEEEEEEEEEEEEEEEEEEEEEEEEEEEEEEEEWW
NNEEEEEEEEEEEEEEEEEEEEEEEEEEEEEEEEEEEEEEEEEEEEEEEEEEEEEEEEEEEEWW
NNEEEEEEEEEEEEEEEEEEEEEEEEEEEEEEEEEEEEEEEEEEEEEEEEEEEEEEEEEEEEWW
NNEEEEEEEEEEEEEEEEEEEEEEEEEEEEEEEEEEEEEEEEEEEEEEEEEEEEEEEEEEEEWW
NNEEEEEEEEEEEEEEEEEEEEEEEEEEEEEEEEEEEEEEEEEEEEEEEEEEEEEEEEEEEEWW
NNEEEEEEEEEEEEEEEEEEEEEEEEEEEEEEEEEEEEEEEEEEEEEEEEEEEEEEEEEEEEWW
NNEEEEEEEEEEEEEEEEEEEEEEEEEEEEEEEEEEEEEEEEEEEEEEEEEEEEEEEEEEEEWW
WWEEEEEEEEEEEEEEEEEEEEEEEEEEEEEEEEEEEEEEEEEEEEEEEEEEEEEEEEEEEEWW
WWEEEEEEEEEEEEEEEEEEEEEEEEEEEEEEEEEEEEEEEEEEEEEEEEEEEEEEEEEEEEWW
WWEEEEEEEEEEEEEEEEEEEEEEEEEEEEEEEEEEEEEEEEEEEEEEEEEEEEEEEEEEEEWW
WWEEEEEEEEEEEEEEEEEEEEEEEEEEEEEEEEEEEEEEEEEEEEEEEEEEEEEEEEEEEEWW
WWWWWWWWWWWWWWWWWWWWWWWWWWWWWEEEEEWWWWWWWWWWWWWWWWWWWWWWWWWWWWWW
WWWWWWWWWWWWWWWWWWWWWWWWWWWWWEEEEEWWWWWWWWWWWWWWWWWWWWWWWWWWWWWW
WWWWWWWWWWWWWWWWWWWWWWWWWWWWWEEEEEWWWWWWWWWWWWWWWWWWWWWWWWWWWWWW
WWWWWWWWWWWWWWWWWWWWWWWWWWWWWEEEEEWWWWWWWWWWWWWWWWWWWWWWWWWWWWWW
