EEEEEEEEEEEEEEEEEEEEEEEEEEEEEEEEEEEEEEEEEEEEEEEEEEEEEEEEEEEEEEEE
EEEEEEEEEEEEEEEEEEEEEEEEEEEEEEEEEEEEEEEEEEEEEEEEEEEEEEEEEEEEEEEE
EEEEEEEEEEEEEEEEEEEEEEEEEEEEEEEEEEEEEEEEEEEEEEEEEEEEEEEEEEEEEEEE
EEEEEEEEEEEEEEEEEEEEEEEEEEEEEEEEEEEEEEEEEEEEEEEEEEEEEEEEEEEEEEEE
EEEEEEEEEEEEEEEEEEEEEEEWWWWWWWEEEEEEEEEEEEEEEEEEEEEEEEEEEEEEEEEE
WWWWWWWWWWWWWWWWWWWWWWWWWWWWWWWWWWWWWWWWWWWWWWWWWWWWWWWWWWWWWWWW
WWWWWWWWWWWWWWWWWWWWWWWWWWWWWWWWWWWWWWWWWWWWWWWWWWWWWWWWWWWWWWWW
NNEEEEEEEEEEEEEEEEEEEEEEEEEEEEEEEEEEEEWWEEEEEEEEEEEEEEE2EEEEEE1F
NNEEEEEEEEEEEEEEEEEEEEEEEEEEEEEEEEEEEEWWEEEEEEEEEEEEEEEEEEEEEEWF
NNEEEEEEEEEEEEEEEEEEEEEEEEEEEEEEEEEEEEWWEEEEEEEEEEEEEEEEEEEEEEWF
NNEEEEEEEEEEEEEEEEEEEEEEEEEEEEEEEEEEEEWWEEEEEEEEEEEEEEEEEEEEEEWF
NNEEEEEEEEEEEEEEEEEEEEEEEEEEEEEEEEEEEEWWEEEEEWWWWW6WWWWWW5WWWWWW
NNEEEEEEEEEEEEEEEEEEEEEEEEEEEEEEEEEEEEWWEEEEEWWWWWWWWWWWWWWWWWWW
NNEEEEEEEEEEEEEEEEEEEEEEEEEEEEEEEEEEEEWWEEEEEEEEEEEEEEEEEEEEEENN
NNEEEEEEEEEEEEEEEEEEEEEEEEEEEEEEEEEEEEWWEEEEEEEEEEEEEEEEEEEEEENN
NNEEEEEEEEEEEEEEEEEEEEEEEEEEEEEEEEEEEEWWEEEEEEEEEEEEEEEEEEEEEENN
NNEEEEEEEEEEEEEEEEEEEEEEEEEEEEEEEEEEEEWWEEEEEEEEEEEEEEEEEEEEEENN
NNEEEEEEEEEEEEEEWWEEEEEEEEEEEEEEEEEEEEWWEEEEEEEEEEEEEEEEEEEEEENN
NNEEEEEEEEEEEEEEWWEEEEEEEEEEEEEEEEEEEEWWEEEEEEEEEEEEEEEEEEEEEENN
NNEEEEEEEEEEEEEEWWEEEEEEEEEEEEEEEEEEEEWWEEEEEEEEEEEEEEEEEEEEEENN
NNEEEEEEEEEEEEEEWWEEEEEEEEEEEEEEEEEEEEWWEEEEEEEEEEEEEEEEEEEEEENN
NNEEEEEEEEEEEEEEWWEEEEEEEEEEEEEEEEEEEEWWEEEEEEEEEEEEEEEEEEEEEENN
NNEEEEEEEEEEEEEEWWEEEEEEEEEEEEEEEEEEEEWWEEEEEEEEEEEEEEEEEEEEEENN
NNEEEEEEEEEEEEEEWWEEEEEEEEEEEEEEEEEEEEWWEEEEEEEEEEEEEEEEEEEEEENN
NNEEEEEEEEEEEEEEWWEEEEEEEEEEEEEEEEEEEEWWEEEEEEEEEEEEEEEEEEEEEENN
NNEEEEEEEEEEEEEEWWEEEEEEEEEEEEEEEEEEEEWWEEEEEEEEEEEEEEEEEEEEEENN
NNEEEEEEEEEEEEEEWWEEEEEEEEEEEEEEEEEEEEE0EEEEEEEEEEEEEEEEEEEEEENN
NNEEEEEEEEEEEEEEWWEEBEEEEEEEEEEEEEEEEEEEEEEEEEEEEEEEEEEEEEEEEENN
NNEEEEEEEEEEEEEEWWEEEEEEEEEEEEEEEEEEEEEEEEEEEEEEEEEEEEEEEEEEEENN
NNEEEEEEEEEEEEEEWWEEEEEEEEEEEEEEEEEEEEEEEEEEEEEEEEEEEEEEEEEEEENN
NNEEEEEEEEEEEEEEWWWWWWWWWWWWWWWW4WWWWWWWWWWWWWWWWWWWWWWWWWWWWWWW
NNEEEEEEEEEEEEEEWWWWWWWWWWWWWWWWWWWWWWWWWWWWWWWWWWWWWWWWWWWWWWWW
NNEEEEEEEEEEEEEEEEEEEEEEEEEEEEEEEEEEEEEEEEEEEEEEEEEEEEEEEEEEEEEE
NNEEEEEEEEEEEEEEEEEEEEEEEEEEEEEEEEEEEEEEEEEEEEEEEEEEEEEEEEEEEEEE
NNEEEEEEEEEEEEEEEEEEEEEEEEEEEEEEEEEEEEEEEEEEEEEEEEEEEEEEEEEEEEEE
NNEEEEEEEEEEEEEEEEEEEEEEEEEEEEEEEEEEEEEEEEEEEEEEEEEEEEEEEEEEEEEE
NNEEEEEEEEEEEEEEEEEEEEEEEEEEEEEEEEEEEEEEEEEEEEEEEEEEEEEEEEEEEEEE
NNEEEEEEEEEEEEEEEEEEEEEEEEEEEEEEEEEEEEEEEEEEEEEEEEEEEEEEEEEEEEEE
NNEEEEEEEEEEEEEEEEEEEEEEEEEEEEEEEEEEEEEEEEEEEEEEEEEEEEEEEEEEEEEE
NNEEEEEEEEEEEEEEEEEEEEEEEEEEEEEEEEEEEEEEEEEEEEEEEEEEEEEEEEEEEEEE
NNEEEEEEEEEEEEEEEEEEEEEEEEEEEEEEEEEEEEEEEEEEEEEEEEEEEEEEEEEEEEEE
NNEEEEEEEEEEEEEEEEEEEEEEEEEEEEEEEEEEEEEEEEEEEEEEEEEEEEEEEEEEEEEE
NNEEEEEEEEEEEEEEEEEEEEEEEEEEEEEEEEEEEEEEEEEEEEEEEEEEEEEEEEEEEEEE
NNEEEEEEEEEEEEEEEEEEEEEEEEEEEEEEEEEEEEEEEEEEEEEEEEEEEEEEEEEEEEEE
NNEEEEEEEEEEEEEEEEEEEEEEEEEEEEEEEEEEEEEEEEEEEEEEEEEEEEEEEEEEEEEE
NNEEEEEEEEEEEEEEEEEEEEEEEEEEEEEEEEEEEEEEEEEEEEEEEEEEEEEEEEEEEEEE
NNEEEEEEEEEEEEEEEEEEEEEEEEEEEEEEEEEEEEEEEEEEEEEEEEEEEEEEEEEEEEEE
NNEEEEEEEEEEEEEEEEEEEEEEEEEEEEEEEEEEEEEEEEEEEEEEEEEEEEEEEEEEEEEE
NNEEEEEEEEEEEEEEEEEEEEEEEEEEEEEEEEEEEEEEEEEEEEEEEEEEEEEEEEEEEEEE
NNEEEEEEEEEEEEEEEEEEEEEEEEEEEEEEEEEEEEEEEEEEEEEEEEEEEEEEEEEEEEEE
NNEEEEEEEEEEEEEEEEEEEEEEEEEEEEEEEEEEEEEEEEEEEEEEEEEEEEEEEEEEEEEE
NNEEEEEEEEEEEEEEEEEEEEEEEEEEEEEEEEEEEEEEEEEEEEEEEEEEEEEEEEEEEEEE
NNEEEEEEEEEEEEEEEEEEEEEEEEEEEEEEEEEEEEEEEEEEEEEEEEEEEEEEEEEEEEEE
NNEEEEEEEEEEEEEEEEEEEEEEEEEEEEEEEEEEEEEEEEEEEEEEEEEEEEEEEEEEEEEE
NNEEEEEEEEEEEEEEEEEEEEEEEEEEEEEEEEEEEEEEEEEEEEEEEEEEEEEEEEEEEEEE
NNEEEEEEEEEEEEEEEEEEEEEEEEEEEEEEEEEEEEEEEEEEEEEEEEEEEEEEEEEEEEEE
WWEEEEEEEEEEEEEEEEEEEEEEEEEEEEEEEEEEEEEEEEEEEEEEEEEEEEEEEEEEEEWW
WWEEEEEEEEEEEEEEEEEEEEEEEEEEEEEEEEEEEEEEEEEEEEEEEEEEBEEEEEEEEEWW
WWEEEEEEEEEEEEEEEEEEEEEEEEEEEEEEEEEEEEEEEEEEEEEEEEEEEEEEEEEEEEWW
WWEEEEEEEEEEEEEEEEEEEEEEEEEEEEEEEEEEEEEEEEEEEEEEEEEEEEEEEEEEEEWW
WWWWWWWWWWWWWWWWWWWWWEEEWWWEEEWWWEEEWWWEEEWWWEEEWWWWWWWWWWWWWWWW
WWWWWWWWWWWWWWWWWWWWWEEEWWWEEEWWWEEEWWWEEEWWWEEEWWWWWWWWWWWWWWWW
WWWWWWWWWWWWWWWWWWWWWEEEWWWEEEWWWEEEWWWEEEWWWEEEWWWWWWWWWWWWWWWW
WWWWWWWWWWWWWWWWWWWWWEEEWWWEEEWWWEEEWWWEEEWWWEEEWWWWWWWWWWWWWWWW
